Pos;Equipe;Pts;J;V;E;D;GP;GC;SG
1;Austrália;20;8;6;2;0;12;1;11
2;Japão;15;8;4;3;1;11;6;5
3;Bahrein;10;8;3;1;4;6;8;-2
4;Catar;6;8;1;3;4;5;14;-9
5;Uzbequistão;4;8;1;1;6;5;10;-5
1;Coreia do Sul;16;8;4;4;0;12;4;8
2;Coreia do Norte;12;8;3;3;2;7;5;2
3;Arábia Saudita;12;8;3;3;2;8;8;0
4;Irã;11;8;2;5;1;8;7;1
5;Emirados Árabes Unidos;1;8;0;1;7;6;17;-11
